22 35
11 11 11 12 11 12 12 11 11 11 12 12 11 12 11 12 12 11 11 12 11 12 12 11 11 11 12 11 11 11 11 12 11 11 12
12 9 10 10 10 10 10 10 10 10 10 10 10 10 10 10 10 10 10 10 10 10 10 10 10 10 10 10 10 10 10 10 10 8 12
12 7 0 0 0 0 0 0 0 0 0 0 0 0 0 0 0 0 0 0 0 0 0 0 0 0 0 0 0 0 0 0 0 6 12
12 7 0 0 0 0 0 0 0 0 0 0 0 0 0 0 0 0 0 0 0 0 0 0 0 0 0 0 0 0 0 0 0 6 12
12 7 0 0 0 0 0 0 0 0 0 0 0 0 0 0 0 0 0 0 0 0 0 0 0 0 0 0 0 0 0 0 0 6 11
12 7 0 0 0 0 0 0 0 0 0 0 0 0 0 0 0 0 0 0 0 0 0 0 0 0 0 0 0 0 0 0 0 6 12
12 7 0 0 0 0 0 0 0 0 0 0 0 0 0 0 0 0 0 0 0 0 0 0 0 0 0 0 0 0 0 0 0 6 11
12 7 0 0 0 0 0 0 0 0 0 0 0 0 0 0 0 0 0 0 0 0 0 0 0 0 0 0 0 0 0 0 0 6 12
11 7 0 0 0 0 0 0 0 0 0 0 0 0 0 0 0 0 0 0 0 25 0 0 0 0 0 0 0 0 0 0 0 6 12
11 7 0 0 0 0 0 0 0 0 0 0 0 0 0 0 0 0 0 0 0 0 20 0 0 0 0 0 0 0 0 0 0 6 12
12 7 0 0 0 0 0 0 0 0 0 0 0 0 0 0 0 0 0 0 0 0 19 0 0 0 0 0 0 0 0 0 0 6 11
11 7 0 0 0 0 0 0 0 0 0 0 0 0 0 0 0 0 0 15 16 16 18 0 0 0 0 0 0 0 0 0 0 6 11
11 7 0 0 0 0 0 0 0 0 0 0 0 0 0 0 0 0 6 12 7 0 0 0 0 0 0 0 0 0 0 0 0 6 12
11 7 0 0 0 0 0 0 0 0 0 0 0 0 0 0 0 0 6 12 7 0 0 0 0 0 0 0 0 0 0 0 0 6 11
12 7 0 0 0 0 0 0 0 0 0 0 0 0 0 23 26 0 6 12 7 0 0 0 0 0 0 0 0 0 0 0 0 6 12
11 7 0 0 0 0 0 0 0 0 0 0 0 0 0 0 0 0 6 12 7 0 0 0 0 0 0 0 0 0 0 0 0 6 11
12 7 0 0 0 0 0 0 0 0 0 0 0 0 0 0 0 0 6 12 7 0 0 0 0 0 0 0 0 0 0 0 0 6 12
12 7 0 22 0 0 24 0 0 0 0 0 15 18 0 0 0 0 6 12 7 0 27 28 29 0 0 0 0 0 0 0 30 6 12
11 7 0 0 0 0 0 0 0 0 0 0 0 0 0 0 0 0 6 12 7 0 0 0 0 0 0 0 0 0 0 0 0 6 12
11 7 0 0 0 0 0 0 0 0 0 0 0 0 0 0 0 0 6 12 7 0 0 0 0 0 0 0 0 0 0 0 21 6 12
13 2 3 2 3 2 2 2 2 2 2 2 2 2 2 2 2 2 3 12 3 3 2 2 2 3 2 3 3 3 2 2 2 2 14
12 11 11 12 11 12 12 11 11 11 12 11 11 11 11 12 11 11 11 12 11 12 12 11 11 11 12 11 11 11 11 12 11 11 12

2 2

1
21 11

3
25 2
26 2
27 2

1
28 2

1
12 2