15 15
12 12 12 11 11 12 11 12 12 11 11 11 12 11 11
12 9 10 10 10 10 10 10 10 10 10 10 10 8 12
12 7 0 0 0 0 0 0 0 0 21 0 0 6 12
12 7 0 0 15 16 16 16 17 16 17 18 0 6 12
12 7 0 0 0 0 0 0 0 0 0 0 0 6 12
12 7 0 0 0 20 0 0 0 0 0 0 0 6 12
12 7 0 0 0 19 0 0 0 0 0 0 0 6 12
12 7 0 0 0 5 0 0 0 0 0 0 0 6 12
12 7 0 0 0 0 0 0 0 0 0 0 0 6 12
12 7 0 0 0 0 0 0 0 0 0 0 0 6 12
12 7 0 0 0 0 0 0 0 0 0 0 0 6 12
12 7 0 0 0 0 0 0 0 0 0 0 0 6 12
12 7 0 0 0 0 0 0 0 0 0 0 0 6 12
13 2 2 2 2 2 2 2 2 2 2 2 2 2 14
12 12 12 11 11 12 11 12 12 11 11 11 12 11 11

7 2

1
13 8

3
4 2
6 2
8 2

3
4 12
5 12
6 12

23
13 2
13 6
13 10
12 2
12 6
12 10
11 2
11 6
11 10
10 2
10 6
10 10
1 2
1 6
1 10
2 2
2 6
2 10
3 2
3 6
3 10
4 2
4 6