25 25
11 11 11 12 11 12 12 11 11 11 12 12 11 11 11 11 12 11 12 12 11 11 11 12 12
12 9 10 10 10 10 10 10 10 10 10 10 10 10 10 10 10 10 10 10 10 10 10 6 12
12 7 0 0 0 0 0 0 0 0 0 0 0 0 0 0 0 0 0 0 0 0 0 6 12
12 7 0 21 0 0 0 0 0 0 0 0 0 0 0 0 0 0 0 0 0 0 0 6 12
12 7 0 15 16 16 18 0 0 0 0 0 0 0 0 0 0 0 0 0 0 0 0 6 12
12 7 0 0 0 0 0 0 0 0 0 0 0 0 0 0 0 0 0 0 0 0 0 6 12
12 7 0 0 0 0 0 0 0 0 0 0 0 0 0 0 0 0 0 0 0 0 0 6 12
12 7 0 0 0 0 0 0 0 0 0 5 0 0 0 0 0 0 0 0 0 0 0 6 12
12 7 0 0 0 0 0 0 0 0 0 0 0 0 0 0 0 0 0 0 0 0 0 6 12
12 7 0 0 0 0 0 0 0 0 0 0 0 0 0 0 0 0 0 0 0 0 0 6 12
12 7 0 0 0 0 0 0 0 0 0 0 0 0 0 0 0 0 0 0 0 0 0 6 12
12 7 0 0 0 0 0 0 0 0 0 0 0 0 0 0 6 12 7 0 6 12 7 6 12
12 7 0 0 0 0 0 0 0 0 0 0 0 0 0 0 6 13 2 2 3 14 7 6 12
12 7 0 0 0 0 0 0 0 0 0 20 0 0 0 0 6 12 12 12 12 12 7 6 12
12 7 0 0 0 0 0 0 0 0 0 19 0 0 0 0 0 10 10 10 10 10 0 6 12
12 7 0 0 0 0 0 0 0 0 0 20 0 0 0 0 0 0 0 0 0 0 0 6 12
12 7 0 0 0 0 0 0 0 0 0 19 0 0 0 0 0 0 0 0 0 0 0 6 12
12 7 0 0 0 0 0 0 0 0 0 15 18 0 0 0 0 0 0 0 0 0 0 6 12
12 7 0 0 0 0 0 0 0 0 0 0 0 0 0 0 0 0 0 0 0 0 0 6 12
12 7 0 0 0 0 0 0 0 0 0 0 0 0 0 0 0 0 0 0 0 0 0 6 12
12 7 0 0 15 18 0 0 0 0 0 0 0 0 0 0 0 0 0 0 0 0 0 6 12
12 7 0 0 0 0 0 0 0 0 0 0 0 0 0 0 0 0 0 0 0 0 0 6 12
12 7 0 0 0 0 0 0 0 0 0 0 0 0 0 0 0 0 0 0 0 0 0 6 12
13 2 2 2 2 2 2 2 2 2 2 2 2 2 2 2 2 2 2 2 2 2 2 2 14
11 11 11 12 11 12 12 11 11 11 12 12 11 11 11 11 12 11 12 12 11 11 11 12 12

2 2

1
4 5

3
12 8
13 2
14 2

1
11 18

2
14 2
19 12